..........A
.....w1....
g..........
ww.........
.........w.
.........+.
.2.........