.....w.....
Aww...w....
...w..w.g..
....w......
.ww...w....
.ww..2.w...
1w..+...ww.