g........ww
...........
....w......
...........
....w......
.A..w...+..
....w......