...........
....w......
....Aw.....
....w....+.
..gw.......
..w........
...........