...........
...1+....3.
..w........
..w.....ww.
..w..Ag....
...........
.....w..2..