.........A.
...w...w.w.
...w...ww+.
...w3..ww..
.......w...
.2.www.....
..g..1.w...