1......w..A
.w.....w.ww
.w.w.......
+wgwww....w
.w.w.......
.w.....w...
1......w1w1