..3........
ww..g.www..
www........
...A..www..
1.....ww...
..3.www.+ww
..3...w...w