...w...w.A.
.w..1w...w.
.w...w..3w.
gw..www..w.
.w...w..ww.
...2.w.ww..
.....w..+..