.3ww....A..
...........
g....wwwwww
..ww.....22
wwwwww.....
..ww....ww+
..2..w.....