...........
.....w.....
.....w.....
....w......
....Aw+wg..
.......w...
...........