..w..+....3
..w..w.....
....1w1....
...wwwww...
.........w.
..w..w..ww.
g....A.....