...........
..2+.......
....ww.....
.....w.....
....Awww...
...........
.......g...