.....ww.+ww
ww...1..w.A
.ww.......w
.ww...1....
ww........1
g...www.ww.
ww.........