w3........1
gw...w.....
.Aw...w....
...w...w...
....w...w..
.....w...w+
1........2w