...........
.......A...
..+...www..
...........
....w...g..
....w......
....w......