..........g
....w......
.w.w..1....
+w.........
w1..2..3...
..w..w.w.w.
...A.......