........w..
..w.....w22
1.wwwww....
......w....
..w...www..
+www.......
..w....wwAg