.+...A.w.g.
.......w.w.
...........
....w......
...........
....w......
...........