..A........
.wwwww..ww.
.w.......g.
....w...ww.
..ww.ww..ww
...+..ww...
...........