3.........2
.....w.....
....+w1....
..wwwwwww..
....Awg....
.....w.....
2.........3