...........
.....w.....
.....w.....
...A....w..
..wwww..w..
........w.+
wwg..wwwwww