..A......1.
......www..
.ww.....w..
.....ww....
.ww....www+
1...ww.....
...gw1.....