www......ww
w.......+.w
.....2.....
.g.........
..........w
www...A..ww
www.....www