...........
...w...3...
...ww+ww...
.....wgw...
.www....w..
...ww...w..
..A...3....