...........
...........
......g.w..
....w......
.....wwww..
...A.......
..........+