....w....g.
...www.....
.2..www....
..wwwwwww..
......w....
....w...2..
A...w+...1.