.3.....ww..
..w........
....ww1....
..+....wwA.
....ww..ww.
.ww.ww..w..
...3.....g.