A.......w..
..w........
...w...w.+w
ww.w2..wwww
.......w.g.
.2.........
.....2.....