..w....+..w
..w...www..
..www.....3
.A........w
w..w..www..
...w....w.g
.2.w.1..w..