3...w......
..Aw.w.....
.........w.
..ww.ww..w.
......w....
3...ww..wg.
ww..w+...1.