.3.gw....1.
..www......
..........2
.......wwww
.......w+..
...w...w...
A..w.......