1...w.....1
..w......ww
....www.gw+
ww.w.A.www.
...w...w...
.w.....w...
1..w.......