........+..
.1..wwww...
.gw....w...
www...ww...
wwww.......
..A...www..
.....www..1