......w....
...+..w....
......w....
......w....
.........A.
....w......
..w......g.