..3.ww....A
....w......
.w.....wwww
+w........1
.w..wwwwwww
.......w...
...2w....wg