.....gw....
.wwwww..ww.
.......w...
wwwwwww..ww
..A..w..w..
.......w..+
...........